14x13x5
A=minecraft:air,0;C=minecraft:cobblestone,0;D=minecraft:stone_stairs,2;E=minecraft:wooden_slab,0;F=minecraft:stone_stairs,1;G=minecraft:stone_stairs,3;H=minecraft:leaves,4;I=minecraft:leaves,12;J=minecraft:glass,0;K=minecraft:log,0;AU=Subby72;
CCDDCCCCCCCCCCCEEEEC*CCCCCCCCEEEEFCCCCCCCCCEEEEFCCCCCCCCCEEEECCCCCCCCCCCCCCCCCC*C*CCCCCCC*CCCCCCCCCCCCCCCCCCC*CCC*CCCCCCCCCCCCCCCCCCCC*CCCCCCCCCCC*CCCCCCCCCCCCCCCCCCC*CCGGCCCCCCCCCCC
CCAACCCCCCCCCCCAAAACAAAAAAHCCAAAAAAAHAHAHCCAAAAAAAHAIAHCCAAAACHHHAHAHCCCCCCCAAAAHAACCAAAAAHHHHHHACCHHHHAAHAAAAACCAAAAHAHAHHAHCCAAHAHAHAAHAACCAAHAAAHHHHHACCAAIAHAAAAAAACCAACCCCCCCCCCC
CCAACCCJCCCJCCCAAAACAAAAAAAJJAAAAAAAHAIAHCJAAAAAAAHAIAHCCAAAACHHHAHAHCCCJJCCAAAAHAAJJAAAAAHHHHHHAJCHHHHAAHAAAAAJCAAAAHAHAHHAHCJAAHAHAHAAHAAJJAAHAAAHHHHHAJCAAIAHAAAAAAACCAACJCCJJJJCCC
CCCCCCCCCCCCCCCCCC*CHHHHHHHCCCCCCCHHHHHHHCCCCCCCHHHHHHHCC*CCCCHHHHHHHCCCCCCCHHHHHHHCCHHHHHHHHHHHHCCHHHHHHHHHHHHCCCCCHHHHHHHHHCCCCCHHHHHHHHHCCCCCHHHHHHHHHCCCCCHHHHHHHHHCCCCCCCCCCCCCCC
AAAAAAAAAAAAAAAAAAAAAAAAAA*AAAAAAAAAAAAAAAAAAAAAAAKAAAAAAAAAAAAAAAAKAAAAAAAAAAAAAAAAAAAAAAAAKAAAAAAAAAAAAAAAAAAAAAAAAKAAAAKAAAAAAAAAAAAAAAAAAAAAAAAAAAAAAAA*AAAAAKAAAA*AAAAAAAAAAAAAAA
