19x36x9
A=minecraft:air,0;C=minecraft:double_stone_slab,5;D=minecraft:log,1;E=minecraft:stonebrick,0;F=minecraft:brick_block,0;G=minecraft:planks,0;H=minecraft:leaves,5;I=minecraft:leaves,13;J=minecraft:bed,9;K=minecraft:bed,1;L=minecraft:chest,4;M=minecraft:chest,3;N=minecraft:torch,5;O=minecraft:glass_pane,0;P=minecraft:torch,3;Q=minecraft:torch,1;R=minecraft:crafting_table,0;S=minecraft:torch,2;T=minecraft:furnace,5;U=minecraft:torch,4;V=minecraft:wool,10;W=minecraft:double_stone_slab,4;AU=Razor9119;
CCCCCCCCCCCCCCCCCCC$DDDDEEEEEEEEEDDDDDDDDDDEEEEEEEEEDDDDDDDDEEEEEEEEEEEEEDDDDDDEEEEEEEEEEEEEDDDDFFFFFFFFFFFFFFFFFDDFGGGGGGGGGGGGGGGFDDFGGGGGGGGGGGGGGGFDDFGGGGGGGGGGGGGGGFDDFGGGGGGGGGGGGGGGFDDFGGGGGGGGGGGGGGGFDDFGGGGGGGGGGGGGGGFDDFGGGGGGGGGGGGGGGFDDFGGGGGGGGGGGGGGGFDDFGGGGGGGGGGGGGGGFDDFGGGGGGGGGGGGGGGFDDFGGGGGGGGGGGGGGGFDDFGGGGGGGGGGGGGGGFDDFFFFFFFFFFFFFFFFFDDDDEDDDDDDEDDDEDDDDDEEEEDEEEEEDDDEDDDDDEDDEDEDDDEDDDEDDDDDEEDEDEDEEEEEEEDDDDDDEDEEEDEDDDEDEDDDDDDEEDDEEDEEEEDEEEDDDEEDDDDEDEDDEDDDEDDDDEEEEDEDEDDEDEEEDDDDDEDEDEDEDDEDDDDDDDDDEDEDEDEEDEEEEDDDDEEEDDDEDDEDDDDEDDDDEDEEEEDEDEEEEDEDDDDEDDDDEEEDDEDDEEDDDDEEEEEDDDEEEDEEDDDDDDDDDEEEEDDDDDDDDDDDDDDDDDDEDDDDDDDDDDCCCCCCCCCCCCCCCCCCC
AAAAAAAAAAAAAAAAAAAHHHHIAAAA!AAAAHHHHHHHIIIAAAAAAAAAHHHHHHHIAAAAAAAAAAAAAHHHIIIAAAAAAAAAAAAAHHIIFFFFAFFFFFFFAFFFFHIFAAAAAAAAAAAAAAAFHHFAAAAAAAAAAAAAAAFHHFAAAAAAAAAAAAAAAFHHFAAAFFFAFAFFFAAAFHHFAAAFJKAFAALFAAAFHHFAAAFJKAFAALFAAAFHHFAAAFFFFFFFFFAAAFHHFAAAAAAAFAAAAAAAFHHFAAAFAAAFAAAFAAAFHHFAAAFAAAFAAAFAAAFHHFAAAFAAAFAAAFAAAFHHFAAAFAMMFMMAFAAAFHHFFAFFFFFFFFFFAFFFIHHHAHHHHHHAHHHAHHHIHNAANHAAAAAHHHAHHHHHAHHAHAHHHAHHHAHHHHHNNHAHAHNAAANAAHHHHHHAHNAAHAHHHAHAHHHHHHAAHHAAHNAANHNAAHHHAAHHHHAHAHHAHHHAHHHHNAANHAHAHHAHNANHHHHHAHAHAHAHHAHHHHHHHHHAHNHAHANHNAANHHHHAAAHHHAHHAHHHHAHHHHAHNAANHNHAAANHAHHHHAHHHHAAAHHAHHAAHHHHNAAANHHHNAAHNAHHHHHHHHHAAANHHHHHHHHHHHHHHHHHHAHHHHHHHHHHAAAAAAAAAAAAAAAAAAA
AAAAAAAAAAAAAAAAAAAHHHHIAAAAAAAAAHHHHHHHIIIAAAAAAAAAHHHHHHHIAAAAAAAAAAAAAHHHIIIAAAAAAAAAAAAAHHIIFFFFAFFFFFFFAFFFFHHFAAAAAAAAAAAAAAAFHAOAAAAAAAAAAAAAAAOAAOAAAAAAAAAAAAAAAOAAOAAAFFFAFAFFFAAAOAAOAAAFAAAFAAAFAAAOAAOAAAFAAAFAAAFAAAOAAOAAAFFFFFFFFFAAAOAAOAAAAAAAFAAAAAAAOAAOAAAFAAAFAAAFAAAOAAOAAAFAAAFAAAFAAAOAAOAAAFAAAFAAAFAAAOAHFAAAFAAAFAAAFAAAFHHFFAFFFFFFFFFFAFFFHHHHAHHHHHHAHHHAHHHIHAAAAHAAAAAHHHAHHHHHAHHAHAHHHAHHHAHHHHHAAHAHAHAAAAAAAHHHHHHAHAAAHAHHHAHAHHHHHHAAHHAAHAAAAHAAAHHHAAHHHHAHAHHAHHHAHHHHAAAAHAHAHHAHAAAHHHHHAHAHAHAHHAHHHHHHHHHAHAHAHAAHAAAAHHHHAAAHHHAHHAHHHHAHHHHAHAAAAHAHAAAAHAHHHHAHHHHAAAHHAHHAAHHHHAAAAAHHHAAAHAAHHHHHHHHHAAAAHHHHHHHHHHHHHHHHHHAHHHHHHHHHHAAAAAAAAAAAAAAAAAAA
AAAAAAAAAAAAAAAAAAAAAAAAAAAAAAAAAAAAAAAAAAAAAAAAAAAAAAAAAAAAAAAAAAAAAAAAAAAAAAPAAPAAAAAAAPAAPAAAFFFFFFFFFFFFFFFFFAAFAAAAAAAAAAAAAAAFAAFAAAAAAAAAAAAAAAFAAFAAAAAAAAAAAAAAAFAAFAAAFFFFFFFFFAAAFAAFAAAFQAAFRASFAAAFAAFAAAFQAAFTASFAAAFAAFAAAFFFFFFFFFAAAFAAFAAAFAAAFAAAFAAAFAAFAAAFAAAFAAAFAAAFAAFAAAFAAAFAAAFAAAFAAFAAAFAAAFAAAFAAAFAAFAAAFPAPFPAPFAAAFAAFFFFFFFFFFFFFFFFFAAAAUAAAAAAUAAAUAAUAAAAAAAAAAAAAAAAAAAAAAAAAAAAAAAAAAAAAAAAAAAAAAAAAAAAAAAAAAAAAAAAAAAAAAAAAAAAAAAAAAAAAAAAAAAAAAAAAAAAAAAAAAAAAAAAAAAAAAAAAAAAAAAAAAAAAAAAAAAAAAAAAAAAAAAAAAAAAAAAAAAAAAAAAAAAAAAAAAAAAAAAAAAAAAAAAAAAAAAAAAAAAAAAAAAAAAAAAAAAAAAAAAAAAAAAAAAAAAAAAAAAAAAAAAAAAAAAAAAAAAAAAAAAAAAAAAAAAAAAAAAAAAAAAAAAAAAAAAAAAAAAA
AAAAAAAAAAAAAAAAAAAAAAAAAAAAAAAAAAAAAAAAAAAAAAAAAAAAAAAAAAAAAAAAAAAAAAAAAAAAAAAAAAAAAAAAAAAAAAAAFFFFFFFFFFFFFFFFFAAFVVVVVVVVVVVVVVVFAAFVVVVVVVVVVVVVVVFAAFVVVVVVVVVVVVVVVFAAFVVVVVVVVVVVVVVVFAAFVVVVVVVVVVVVVVVFAAFVVVVVVVVVVVVVVVFAAFVVVVVVVVVVVVVVVFAAFVVVVVVVVVVVVVVVFAAFVVVVVVVVVVVVVVVFAAFVVVVVVVVVVVVVVVFAAFVVVVVVVVVVVVVVVFAAFVVVVVVVVVVVVVVVFAAFFFFFFFFFFFFFFFFFAAAAAAAAAAAAAAAAAAAAAAAAAAAAAAAAAAAAAAAAAAAAAAAAAAAAAAAAAAAAAAAAAAAAAAAAAAAAAAAAAAAAAAAAAAAAAAAAAAAAAAAAAAAAAAAAAAAAAAAAAAAAAAAAAAAAAAAAAAAAAAAAAAAAAAAAAAAAAAAAAAAAAAAAAAAAAAAAAAAAAAAAAAAAAAAAAAAAAAAAAAAAAAAAAAAAAAAAAAAAAAAAAAAAAAAAAAAAAAAAAAAAAAAAAAAAAAAAAAAAAAAAAAAAAAAAAAAAAAAAAAAAAAAAAAAAAAAAAAAAAAAAAAAAAAAAAAAAAAAAAAAA
AAAAAAAAAAAAAAAAAAAAAAAAAAAAAAAAAAAAAAAAAAAAAAAAAAAAAAAAAAAAAAAAAAAAAAAAAAAAAAAAAAAAAAAAAAAAAAAANAAAAAAAAAAAAAAANAAAWWWWWWWWWWWWWWWAAAAWFFFFFFFFFFFFFWAAAAWFFFFFFFFFFFFFWAAAAWFFFFFFFFFFFFFWAAAAWFFFFFFFFFFFFFWAAAAWFFFFFFFFFFFFFWAAAAWFFFFFFFFFFFFFWAAAAWFFFFFFFFFFFFFWAAAAWFFFFFFFFFFFFFWAAAAWFFFFFFFFFFFFFWAAAAWFFFFFFFFFFFFFWAAAAWWWWWWWWWWWWWWWAAANAAAAAAAAAAAAAAANAAAAAAAAAAAAAAAAAAAAAAAAAAAAAAAAAAAAAAAAAAAAAAAAAAAAAAAAAAAAAAAAAAAAAAAAAAAAAAAAAAAAAAAAAAAAAAAAAAAAAAAAAAAAAAAAAAAAAAAAAAAAAAAAAAAAAAAAAAAAAAAAAAAAAAAAAAAAAAAAAAAAAAAAAAAAAAAAAAAAAAAAAAAAAAAAAAAAAAAAAAAAAAAAAAAAAAAAAAAAAAAAAAAAAAAAAAAAAAAAAAAAAAAAAAAAAAAAAAAAAAAAAAAAAAAAAAAAAAAAAAAAAAAAAAAAAAAAAAAAAAAAAAAAAAAAAAAAAAAAAAAA
AAAAAAAAAAAAAAAAAAAAAAAAAAAAAAAAAAAAAAAAAAAAAAAAAAAAAAAAAAAAAAAAAAAAAAAAAAAAAAAAAAAAAAAAAAAAAAAAAAAAAAAAAAAAAAAAAAAAAAAAAAAAAAAAAAAAAAAAAAAAAAAAAAAAAAAAAAAAWWWWWWWWWWWAAAAAAAAWFFFFFFFFFWAAAAAAAAWFFFFFFFFFWAAAAAAAAWFFFFFFFFFWAAAAAAAAWFFFFFFFFFWAAAAAAAAWFFFFFFFFFWAAAAAAAAWFFFFFFFFFWAAAAAAAAWWWWWWWWWWWAAAAAAAAAAAAAAAAAAAAAAAAAAAAAAAAAAAAAAAAAAAAAAAAAAAAAAAAAAAAAAAAAAAAAAAAAAAAAAAAAAAAAAAAAAAAAAAAAAAAAAAAAAAAAAAAAAAAAAAAAAAAAAAAAAAAAAAAAAAAAAAAAAAAAAAAAAAAAAAAAAAAAAAAAAAAAAAAAAAAAAAAAAAAAAAAAAAAAAAAAAAAAAAAAAAAAAAAAAAAAAAAAAAAAAAAAAAAAAAAAAAAAAAAAAAAAAAAAAAAAAAAAAAAAAAAAAAAAAAAAAAAAAAAAAAAAAAAAAAAAAAAAAAAAAAAAAAAAAAAAAAAAAAAAAAAAAAAAAAAAAAAAAAAAAAAAAAAAAAAAAAAAAAAAAAAAAAAAAAAAAAA
AAAAAAAAAAAAAAAAAAAAAAAAAAAAAAAAAAAAAAAAAAAAAAAAAAAAAAAAAAAAAAAAAAAAAAAAAAAAAAAAAAAAAAAAAAAAAAAAAAAAAAAAAAAAAAAAAAAAAAAAAAAAAAAAAAAAAAAAAAAAAAAAAAAAAAAAAAAAAAAAAAAAAAAAAAAAAAAAAAAAAAAAAAAAAAAAAAAAWWWWWWWAAAAAAAAAAAAWFFFFFWAAAAAAAAAAAAWFFFFFWAAAAAAAAAAAAWWWWWWWAAAAAAAAAAAAAAAAAAAAAAAAAAAAAAAAAAAAAAAAAAAAAAAAAAAAAAAAAAAAAAAAAAAAAAAAAAAAAAAAAAAAAAAAAAAAAAAAAAAAAAAAAAAAAAAAAAAAAAAAAAAAAAAAAAAAAAAAAAAAAAAAAAAAAAAAAAAAAAAAAAAAAAAAAAAAAAAAAAAAAAAAAAAAAAAAAAAAAAAAAAAAAAAAAAAAAAAAAAAAAAAAAAAAAAAAAAAAAAAAAAAAAAAAAAAAAAAAAAAAAAAAAAAAAAAAAAAAAAAAAAAAAAAAAAAAAAAAAAAAAAAAAAAAAAAAAAAAAAAAAAAAAAAAAAAAAAAAAAAAAAAAAAAAAAAAAAAAAAAAAAAAAAAAAAAAAAAAAAAAAAAAAAAAAAAAAAAAAAAAAAAAAAAAAAAAAAAAAAAAAAAA
AAAAAAAAAAAAAAAAAAAAAAAAAAAAAAAAAAAAAAAAAAAAAAAAAAAAAAAAAAAAAAAAAAAAAAAAAAAAAAAAAAAAAAAAAAAAAAAAAAAAAAAAAAAAAAAAAAAAAAAAAAAAAAAAAAAAAAAAAAAAAAAAAAAAAAAAAAAAAAAAAAAAAAAAAAAAAAAAAAAAAAAAAAAAAAAAAAAAAAAAAAAAAAAAAAAAAAAANAAANAAAAAAAAAAAAAANAAANAAAAAAAAAAAAAAAAAAAAAAAAAAAAAAAAAAAAAAAAAAAAAAAAAAAAAAAAAAAAAAAAAAAAAAAAAAAAAAAAAAAAAAAAAAAAAAAAAAAAAAAAAAAAAAAAAAAAAAAAAAAAAAAAAAAAAAAAAAAAAAAAAAAAAAAAAAAAAAAAAAAAAAAAAAAAAAAAAAAAAAAAAAAAAAAAAAAAAAAAAAAAAAAAAAAAAAAAAAAAAAAAAAAAAAAAAAAAAAAAAAAAAAAAAAAAAAAAAAAAAAAAAAAAAAAAAAAAAAAAAAAAAAAAAAAAAAAAAAAAAAAAAAAAAAAAAAAAAAAAAAAAAAAAAAAAAAAAAAAAAAAAAAAAAAAAAAAAAAAAAAAAAAAAAAAAAAAAAAAAAAAAAAAAAAAAAAAAAAAAAAAAAAAAAAAAAAAAAAAAAAAAAAAAAAAAAAAAAAAAAAAA
